height,sport,gold,silver,bronze,total
1.76,aquatics,6,7,6,19
1.86,aquatics,6,7,5,18
1.7,aquatics,3,7,8,18
1.73,aquatics,9,5,4,18
1.91,aquatics,10,3,4,17
1.94,aquatics,9,3,1,13
1.8,aquatics,2,5,5,12
1.83,aquatics,7,1,4,12
1.75,aquatics,5,4,3,12
1.88,aquatics,5,6,1,12
1.68,aquatics,3,3,5,11
1.78,aquatics,3,6,1,10
1.84,aquatics,1,2,7,10
1.67,aquatics,2,3,5,10
1.9,aquatics,1,4,4,9
1.93,aquatics,5,1,2,8
1.81,aquatics,4,2,1,7
1.71,aquatics,3,3,1,7
1.77,aquatics,3,1,3,7
1.96,aquatics,5,1,1,7
1.79,aquatics,2,3,1,6
1.95,aquatics,2,3,1,6
1.85,aquatics,0,2,4,6
1.69,aquatics,2,2,2,6
1.99,aquatics,2,2,2,6
1.74,aquatics,0,2,4,6
2,aquatics,1,4,0,5
1.64,aquatics,2,2,1,5
1.87,aquatics,1,3,1,5
1.92,aquatics,0,2,3,5
1.6,aquatics,1,2,2,5
1.97,aquatics,3,0,2,5
1.82,aquatics,1,1,1,3
1.66,aquatics,0,0,2,2
1.89,aquatics,1,0,1,2
1.72,aquatics,0,1,1,2
1.61,aquatics,0,1,1,2
2.01,aquatics,1,1,0,2
1.65,aquatics,0,1,1,2
1.62,aquatics,2,0,0,2
1.59,aquatics,2,0,0,2
1.55,aquatics,0,0,2,2
2.05,aquatics,0,1,1,2
2.06,aquatics,1,0,0,1
1.98,aquatics,0,1,0,1
2.02,aquatics,1,0,0,1
1.63,aquatics,0,0,1,1
1.54,aquatics,0,0,1,1
2.03,aquatics,0,1,0,1
2.21,aquatics,1,0,0,1
1.57,aquatics,1,0,0,1
1.53,aquatics,0,1,0,1
1.49,aquatics,0,0,0,0
1.43,aquatics,0,0,0,0
1.52,aquatics,0,0,0,0
1.58,aquatics,0,0,0,0
2.08,aquatics,0,0,0,0
1.51,aquatics,0,0,0,0
1.56,aquatics,0,0,0,0
1.5,aquatics,0,0,0,0
2.04,aquatics,0,0,0,0
1.81,archery,2,1,1,4
1.8,archery,1,2,0,3
1.58,archery,2,0,1,3
1.67,archery,1,0,1,2
1.74,archery,1,0,1,2
1.78,archery,0,2,0,2
1.69,archery,0,2,0,2
1.65,archery,0,0,2,2
1.86,archery,0,0,1,1
1.68,archery,1,0,0,1
1.76,archery,0,1,0,1
1.85,archery,0,0,1,1
1.9,archery,0,0,0,0
1.71,archery,0,0,0,0
1.62,archery,0,0,0,0
1.94,archery,0,0,0,0
1.57,archery,0,0,0,0
1.64,archery,0,0,0,0
1.84,archery,0,0,0,0
1.73,archery,0,0,0,0
1.6,archery,0,0,0,0
1.63,archery,0,0,0,0
1.66,archery,0,0,0,0
1.82,archery,0,0,0,0
1.91,archery,0,0,0,0
1.53,archery,0,0,0,0
1.77,archery,0,0,0,0
1.83,archery,0,0,0,0
1.75,archery,0,0,0,0
1.59,archery,0,0,0,0
1.7,archery,0,0,0,0
1.61,archery,0,0,0,0
1.88,archery,0,0,0,0
1.72,archery,0,0,0,0
1.68,athletics,5,8,1,14
1.73,athletics,5,4,3,12
1.83,athletics,5,3,3,11
1.75,athletics,3,6,2,11
1.76,athletics,3,2,4,9
1.81,athletics,3,1,4,8
1.78,athletics,3,1,4,8
1.7,athletics,1,4,2,7
1.8,athletics,1,3,3,7
1.85,athletics,4,1,2,7
1.88,athletics,3,2,1,6
1.96,athletics,4,1,1,6
1.66,athletics,2,1,3,6
1.67,athletics,4,1,1,6
1.6,athletics,2,2,1,5
1.86,athletics,1,3,1,5
1.71,athletics,1,1,3,5
1.91,athletics,3,0,2,5
1.93,athletics,1,2,1,4
1.9,athletics,1,1,2,4
1.62,athletics,1,3,0,4
1.72,athletics,0,0,3,3
1.87,athletics,2,0,1,3
1.79,athletics,0,2,1,3
1.98,athletics,0,0,2,2
2.07,athletics,1,0,1,2
1.54,athletics,1,1,0,2
1.64,athletics,0,0,2,2
1.92,athletics,1,1,0,2
1.82,athletics,0,1,1,2
1.65,athletics,0,2,0,2
1.77,athletics,0,2,0,2
1.52,athletics,0,1,1,2
1.55,athletics,0,1,0,1
1.95,athletics,0,0,1,1
1.57,athletics,1,0,0,1
1.63,athletics,1,0,0,1
2.01,athletics,1,0,0,1
1.56,athletics,0,0,1,1
1.61,athletics,0,0,0,0
1.89,athletics,0,0,0,0
1.69,athletics,0,0,0,0
1.5,athletics,0,0,0,0
1.45,athletics,0,0,0,0
2.05,athletics,0,0,0,0
1.21,athletics,0,0,0,0
1.33,athletics,0,0,0,0
1.38,athletics,0,0,0,0
2.04,athletics,0,0,0,0
1.59,athletics,0,0,0,0
1.97,athletics,0,0,0,0
1.47,athletics,0,0,0,0
1.58,athletics,0,0,0,0
1.84,athletics,0,0,0,0
1.53,athletics,0,0,0,0
2.02,athletics,0,0,0,0
1.48,athletics,0,0,0,0
1.74,athletics,0,0,0,0
2,athletics,0,0,0,0
2.08,athletics,0,0,0,0
1.99,athletics,0,0,0,0
1.94,athletics,0,0,0,0
1.49,athletics,0,0,0,0
1.51,athletics,0,0,0,0
1.83,badminton,1,1,1,3
1.72,badminton,1,0,1,2
1.79,badminton,1,1,0,2
1.75,badminton,0,1,1,2
1.73,badminton,0,0,2,2
1.56,badminton,0,0,1,1
1.8,badminton,0,1,0,1
1.88,badminton,1,0,0,1
1.77,badminton,0,1,0,1
1.78,badminton,0,1,0,1
1.7,badminton,0,1,0,1
1.69,badminton,1,0,0,1
1.94,badminton,0,0,1,1
1.6,badminton,1,0,0,1
1.66,badminton,0,1,0,1
1.65,badminton,1,0,0,1
1.81,badminton,1,0,0,1
1.62,badminton,0,0,0,0
1.85,badminton,0,0,0,0
1.76,badminton,0,0,0,0
1.71,badminton,0,0,0,0
1.64,badminton,0,0,0,0
1.74,badminton,0,0,0,0
1.67,badminton,0,0,0,0
1.61,badminton,0,0,0,0
1.89,badminton,0,0,0,0
1.63,badminton,0,0,0,0
1.86,badminton,0,0,0,0
1.87,badminton,0,0,0,0
1.68,badminton,0,0,0,0
1.98,badminton,0,0,0,0
1.84,badminton,0,0,0,0
1.92,badminton,0,0,0,0
1.82,badminton,0,0,0,0
1.91,basketball,0,3,2,5
2.03,basketball,4,1,0,5
1.93,basketball,2,0,3,5
1.95,basketball,1,2,1,4
1.83,basketball,3,0,1,4
1.9,basketball,1,1,2,4
2.1,basketball,1,1,1,3
1.96,basketball,0,2,1,3
1.85,basketball,2,1,0,3
1.75,basketball,2,0,1,3
2.05,basketball,1,1,0,2
2,basketball,2,0,0,2
2.01,basketball,2,0,0,2
1.8,basketball,0,2,0,2
2.11,basketball,1,1,0,2
1.98,basketball,1,0,1,2
1.89,basketball,0,0,1,1
1.7,basketball,0,0,1,1
1.73,basketball,0,0,1,1
1.97,basketball,0,1,0,1
2.02,basketball,0,1,0,1
1.77,basketball,0,1,0,1
1.81,basketball,0,1,0,1
2.06,basketball,0,0,1,1
1.78,basketball,0,0,1,1
1.87,basketball,0,0,1,1
1.88,basketball,0,0,1,1
2.13,basketball,0,1,0,1
2.04,basketball,0,0,1,1
2.09,basketball,0,1,0,1
1.67,basketball,0,1,0,1
1.99,basketball,0,1,0,1
1.76,basketball,0,1,0,1
1.82,basketball,1,0,0,1
2.08,basketball,0,0,1,1
1.79,basketball,0,0,1,1
2.15,basketball,0,0,1,1
2.14,basketball,0,0,0,0
2.18,basketball,0,0,0,0
1.71,basketball,0,0,0,0
1.72,basketball,0,0,0,0
1.65,basketball,0,0,0,0
2.07,basketball,0,0,0,0
1.68,basketball,0,0,0,0
1.74,basketball,0,0,0,0
1.64,basketball,0,0,0,0
2.17,basketball,0,0,0,0
1.84,basketball,0,0,0,0
1.92,basketball,0,0,0,0
1.86,basketball,0,0,0,0
1.94,basketball,0,0,0,0
1.61,basketball,0,0,0,0
1.75,canoe,0,3,3,6
1.78,canoe,0,1,5,6
1.82,canoe,5,1,0,6
1.92,canoe,3,0,2,5
1.68,canoe,4,0,1,5
1.72,canoe,1,3,1,5
1.76,canoe,1,2,1,4
1.89,canoe,2,2,0,4
1.7,canoe,2,0,1,3
1.84,canoe,1,0,2,3
1.86,canoe,2,1,0,3
1.88,canoe,2,1,0,3
1.81,canoe,1,0,1,2
1.87,canoe,0,0,2,2
1.79,canoe,0,1,1,2
1.83,canoe,0,1,1,2
1.65,canoe,0,1,1,2
1.66,canoe,0,0,2,2
2.02,canoe,0,1,1,2
1.93,canoe,0,1,0,1
1.9,canoe,0,0,1,1
1.97,canoe,1,0,0,1
1.69,canoe,0,1,0,1
1.91,canoe,0,1,0,1
1.61,canoe,1,0,0,1
1.96,canoe,0,1,0,1
1.8,canoe,0,1,0,1
1.85,canoe,1,0,0,1
1.99,canoe,0,1,0,1
1.77,canoe,0,1,0,1
1.73,canoe,0,0,1,1
1.71,canoe,0,0,1,1
1.74,canoe,0,1,0,1
1.67,canoe,0,1,0,1
1.95,canoe,0,0,0,0
1.94,canoe,0,0,0,0
1.63,canoe,0,0,0,0
1.53,canoe,0,0,0,0
1.58,canoe,0,0,0,0
1.56,canoe,0,0,0,0
1.59,canoe,0,0,0,0
1.62,canoe,0,0,0,0
1.64,canoe,0,0,0,0
1.55,canoe,0,0,0,0
1.6,canoe,0,0,0,0
1.8,cycling,1,2,4,7
1.71,cycling,0,4,2,6
1.78,cycling,5,0,1,6
1.87,cycling,1,2,2,5
1.83,cycling,2,2,0,4
1.68,cycling,2,2,0,4
1.65,cycling,2,0,2,4
1.76,cycling,0,2,2,4
1.67,cycling,1,0,3,4
1.73,cycling,2,0,2,4
1.85,cycling,2,1,1,4
1.7,cycling,0,1,2,3
1.86,cycling,1,2,0,3
1.64,cycling,2,1,0,3
1.81,cycling,2,0,1,3
1.88,cycling,0,2,0,2
1.6,cycling,1,0,1,2
1.66,cycling,0,0,2,2
1.77,cycling,1,0,1,2
1.58,cycling,1,1,0,2
1.84,cycling,0,2,0,2
1.75,cycling,0,1,0,1
1.91,cycling,0,0,1,1
1.72,cycling,0,0,1,1
1.79,cycling,0,1,0,1
1.62,cycling,0,1,0,1
1.69,cycling,0,0,1,1
1.9,cycling,1,0,0,1
1.96,cycling,0,0,0,0
1.93,cycling,0,0,0,0
1.56,cycling,0,0,0,0
1.61,cycling,0,0,0,0
1.89,cycling,0,0,0,0
1.55,cycling,0,0,0,0
1.94,cycling,0,0,0,0
1.92,cycling,0,0,0,0
1.57,cycling,0,0,0,0
1.95,cycling,0,0,0,0
1.63,cycling,0,0,0,0
1.82,cycling,0,0,0,0
1.59,cycling,0,0,0,0
1.74,cycling,0,0,0,0
1.68,equestrian,2,3,3,8
1.73,equestrian,1,2,2,5
1.8,equestrian,1,1,2,4
1.7,equestrian,1,2,1,4
1.69,equestrian,2,1,0,3
1.76,equestrian,2,1,0,3
1.9,equestrian,0,0,2,2
1.75,equestrian,2,0,0,2
1.82,equestrian,1,1,0,2
1.71,equestrian,1,0,1,2
1.89,equestrian,0,1,1,2
1.63,equestrian,0,0,1,1
1.83,equestrian,0,1,0,1
1.93,equestrian,1,0,0,1
1.62,equestrian,0,0,1,1
1.66,equestrian,0,1,0,1
1.72,equestrian,0,1,0,1
1.81,equestrian,0,0,1,1
1.77,equestrian,1,0,0,1
1.95,equestrian,0,0,0,0
1.51,equestrian,0,0,0,0
1.65,equestrian,0,0,0,0
1.67,equestrian,0,0,0,0
1.58,equestrian,0,0,0,0
1.79,equestrian,0,0,0,0
1.88,equestrian,0,0,0,0
1.6,equestrian,0,0,0,0
1.74,equestrian,0,0,0,0
1.57,equestrian,0,0,0,0
1.78,equestrian,0,0,0,0
1.64,equestrian,0,0,0,0
1.59,equestrian,0,0,0,0
1.94,equestrian,0,0,0,0
1.85,equestrian,0,0,0,0
1.86,equestrian,0,0,0,0
1.96,equestrian,0,0,0,0
1.87,equestrian,0,0,0,0
1.54,equestrian,0,0,0,0
1.84,equestrian,0,0,0,0
1.61,equestrian,0,0,0,0
1.77,fencing,2,3,2,7
1.75,fencing,4,1,0,5
1.76,fencing,1,2,1,4
1.73,fencing,1,1,2,4
1.82,fencing,1,1,1,3
1.67,fencing,1,1,1,3
1.84,fencing,0,2,1,3
1.8,fencing,1,2,0,3
1.88,fencing,0,1,2,3
1.83,fencing,1,0,2,3
1.91,fencing,1,1,1,3
1.71,fencing,0,1,1,2
1.69,fencing,1,1,0,2
1.86,fencing,1,0,1,2
1.85,fencing,0,2,0,2
1.78,fencing,1,0,1,2
1.72,fencing,0,1,1,2
1.68,fencing,1,0,1,2
1.93,fencing,0,0,1,1
1.94,fencing,0,0,1,1
1.74,fencing,0,0,1,1
1.89,fencing,1,0,0,1
1.65,fencing,0,1,0,1
1.92,fencing,0,0,1,1
1.97,fencing,1,0,0,1
1.7,fencing,1,0,0,1
1.9,fencing,0,1,0,1
1.87,fencing,1,0,0,1
1.99,fencing,0,0,0,0
2.05,fencing,0,0,0,0
1.81,fencing,0,0,0,0
1.66,fencing,0,0,0,0
1.58,fencing,0,0,0,0
1.95,fencing,0,0,0,0
1.52,fencing,0,0,0,0
1.96,fencing,0,0,0,0
1.63,fencing,0,0,0,0
1.62,fencing,0,0,0,0
1.55,fencing,0,0,0,0
1.64,fencing,0,0,0,0
1.79,fencing,0,0,0,0
1.98,fencing,0,0,0,0
1.73,football,4,6,2,12
1.72,football,1,4,2,7
1.63,football,2,0,3,5
1.71,football,5,0,0,5
1.85,football,1,4,0,5
1.86,football,4,0,0,4
1.74,football,3,1,0,4
1.66,football,0,3,1,4
1.7,football,3,0,1,4
1.75,football,3,1,0,4
1.64,football,1,0,2,3
1.76,football,1,0,2,3
1.82,football,1,2,0,3
1.77,football,0,2,1,3
1.67,football,1,1,0,2
1.8,football,2,0,0,2
1.68,football,1,1,0,2
1.6,football,0,0,2,2
1.78,football,1,0,1,2
1.79,football,0,2,0,2
1.83,football,1,1,0,2
1.88,football,1,1,0,2
1.89,football,0,1,0,1
1.9,football,0,1,0,1
1.53,football,0,0,1,1
1.84,football,0,1,0,1
1.92,football,0,1,0,1
1.91,football,0,1,0,1
1.93,football,0,1,0,1
1.94,football,0,1,0,1
1.54,football,0,0,0,0
1.55,football,0,0,0,0
1.59,football,0,0,0,0
1.61,football,0,0,0,0
1.81,football,0,0,0,0
1.58,football,0,0,0,0
1.65,football,0,0,0,0
1.69,football,0,0,0,0
1.87,football,0,0,0,0
1.96,football,0,0,0,0
1.62,football,0,0,0,0
1.56,football,0,0,0,0
1.57,football,0,0,0,0
1.95,football,0,0,0,0
1.94,golf,0,0,1,1
1.87,golf,0,1,0,1
1.67,golf,0,1,0,1
1.68,golf,1,0,0,1
1.72,golf,0,0,1,1
1.93,golf,1,0,0,1
1.89,golf,0,0,0,0
1.77,golf,0,0,0,0
1.64,golf,0,0,0,0
1.73,golf,0,0,0,0
1.8,golf,0,0,0,0
1.71,golf,0,0,0,0
1.88,golf,0,0,0,0
1.78,golf,0,0,0,0
1.62,golf,0,0,0,0
1.79,golf,0,0,0,0
1.7,golf,0,0,0,0
1.85,golf,0,0,0,0
1.66,golf,0,0,0,0
1.58,golf,0,0,0,0
1.65,golf,0,0,0,0
1.63,golf,0,0,0,0
1.81,golf,0,0,0,0
1.96,golf,0,0,0,0
1.69,golf,0,0,0,0
1.91,golf,0,0,0,0
1.6,golf,0,0,0,0
1.84,golf,0,0,0,0
1.76,golf,0,0,0,0
1.74,golf,0,0,0,0
1.83,golf,0,0,0,0
1.61,golf,0,0,0,0
1.92,golf,0,0,0,0
1.75,golf,0,0,0,0
1.62,gymnastics,4,0,3,7
1.7,gymnastics,2,3,2,7
1.73,gymnastics,2,3,2,7
1.6,gymnastics,1,3,2,6
1.58,gymnastics,3,3,0,6
1.61,gymnastics,1,3,1,5
1.45,gymnastics,4,0,1,5
1.67,gymnastics,2,0,2,4
1.68,gymnastics,1,2,1,4
1.63,gymnastics,0,1,3,4
1.72,gymnastics,0,2,1,3
1.69,gymnastics,0,2,1,3
1.66,gymnastics,1,1,1,3
1.56,gymnastics,1,2,0,3
1.53,gymnastics,1,1,0,2
1.48,gymnastics,0,0,2,2
1.55,gymnastics,1,0,1,2
1.64,gymnastics,2,0,0,2
1.75,gymnastics,0,1,1,2
1.51,gymnastics,0,1,1,2
1.76,gymnastics,1,0,0,1
1.77,gymnastics,0,0,1,1
1.43,gymnastics,0,0,1,1
1.4,gymnastics,0,0,1,1
1.65,gymnastics,1,0,0,1
1.8,gymnastics,0,1,0,1
1.59,gymnastics,1,0,0,1
1.71,gymnastics,0,0,1,1
1.42,gymnastics,0,1,0,1
1.5,gymnastics,1,0,0,1
1.52,gymnastics,0,0,1,1
1.57,gymnastics,0,0,0,0
1.49,gymnastics,0,0,0,0
1.34,gymnastics,0,0,0,0
1.44,gymnastics,0,0,0,0
1.83,gymnastics,0,0,0,0
1.79,gymnastics,0,0,0,0
1.78,gymnastics,0,0,0,0
1.46,gymnastics,0,0,0,0
1.74,gymnastics,0,0,0,0
1.47,gymnastics,0,0,0,0
1.84,gymnastics,0,0,0,0
1.54,gymnastics,0,0,0,0
1.37,gymnastics,0,0,0,0
1.81,gymnastics,0,0,0,0
1.33,gymnastics,0,0,0,0
1.78,handball,2,3,0,5
1.92,handball,1,2,2,5
1.89,handball,0,3,1,4
1.88,handball,2,0,2,4
1.98,handball,0,2,2,4
2,handball,2,0,1,3
1.72,handball,0,3,0,3
1.86,handball,1,2,0,3
1.82,handball,1,2,0,3
1.94,handball,0,1,2,3
1.68,handball,2,1,0,3
1.65,handball,1,1,0,2
1.99,handball,1,0,1,2
1.8,handball,1,1,0,2
1.76,handball,2,0,0,2
2.03,handball,0,0,2,2
1.74,handball,1,1,0,2
1.85,handball,2,0,0,2
2.02,handball,0,2,0,2
1.95,handball,2,0,0,2
1.97,handball,2,0,0,2
1.84,handball,2,0,0,2
1.9,handball,1,1,0,2
1.79,handball,0,2,0,2
2.01,handball,1,0,0,1
1.77,handball,0,1,0,1
1.81,handball,0,1,0,1
1.83,handball,1,0,0,1
1.91,handball,0,0,1,1
2.1,handball,0,0,1,1
1.71,handball,0,1,0,1
1.96,handball,1,0,0,1
1.66,handball,0,0,0,0
1.69,handball,0,0,0,0
1.73,handball,0,0,0,0
1.63,handball,0,0,0,0
1.67,handball,0,0,0,0
1.64,handball,0,0,0,0
1.93,handball,0,0,0,0
1.7,handball,0,0,0,0
2.07,handball,0,0,0,0
2.06,handball,0,0,0,0
1.87,handball,0,0,0,0
1.61,handball,0,0,0,0
1.75,handball,0,0,0,0
1.7,hockey,1,3,5,9
1.72,hockey,3,3,3,9
1.8,hockey,2,2,3,7
1.86,hockey,2,1,2,5
1.78,hockey,2,3,0,5
1.68,hockey,2,0,2,4
1.73,hockey,1,1,2,4
1.74,hockey,2,2,0,4
1.81,hockey,0,3,1,4
1.85,hockey,0,1,3,4
1.75,hockey,1,1,2,4
1.64,hockey,1,2,0,3
1.79,hockey,1,2,0,3
1.77,hockey,2,0,1,3
1.65,hockey,3,0,0,3
1.76,hockey,2,1,0,3
1.83,hockey,1,0,1,2
1.66,hockey,0,0,2,2
1.84,hockey,0,1,1,2
1.87,hockey,0,1,1,2
1.82,hockey,2,0,0,2
1.9,hockey,0,1,1,2
1.61,hockey,1,0,0,1
1.59,hockey,0,1,0,1
1.55,hockey,0,0,1,1
1.6,hockey,1,0,0,1
1.69,hockey,1,0,0,1
1.92,hockey,0,0,1,1
1.89,hockey,0,1,0,1
1.63,hockey,0,1,0,1
1.52,hockey,1,0,0,1
1.88,hockey,1,0,0,1
1.93,hockey,0,0,1,1
1.96,hockey,0,1,0,1
1.67,hockey,1,0,0,1
1.71,hockey,0,0,0,0
1.95,hockey,0,0,0,0
1.94,hockey,0,0,0,0
1.53,hockey,0,0,0,0
1.62,hockey,0,0,0,0
1.57,hockey,0,0,0,0
1.58,hockey,0,0,0,0
1.6,judo,1,2,2,5
1.7,judo,2,0,2,4
1.69,judo,1,1,2,4
1.8,judo,0,2,1,3
1.73,judo,1,0,2,3
1.77,judo,0,1,1,2
1.72,judo,0,0,2,2
1.78,judo,1,0,1,2
1.67,judo,0,1,1,2
1.68,judo,1,0,1,2
1.81,judo,0,1,1,2
1.62,judo,2,0,0,2
2.03,judo,1,0,1,2
1.82,judo,1,0,1,2
1.63,judo,0,0,1,1
1.53,judo,0,1,0,1
1.91,judo,0,1,0,1
1.85,judo,0,0,1,1
1.88,judo,0,1,0,1
1.76,judo,0,1,0,1
1.89,judo,0,0,1,1
1.87,judo,0,1,0,1
1.5,judo,1,0,0,1
1.97,judo,1,0,0,1
1.64,judo,0,1,0,1
1.56,judo,0,0,1,1
1.93,judo,0,0,1,1
1.61,judo,0,0,1,1
1.57,judo,0,0,1,1
1.83,judo,0,0,1,1
1.65,judo,0,0,1,1
1.66,judo,1,0,0,1
1.86,judo,0,0,1,1
1.59,judo,0,0,0,0
1.95,judo,0,0,0,0
1.54,judo,0,0,0,0
1.94,judo,0,0,0,0
1.79,judo,0,0,0,0
1.71,judo,0,0,0,0
2,judo,0,0,0,0
1.74,judo,0,0,0,0
1.58,judo,0,0,0,0
1.75,judo,0,0,0,0
1.92,judo,0,0,0,0
1.52,judo,0,0,0,0
1.9,judo,0,0,0,0
1.84,judo,0,0,0,0
1.96,judo,0,0,0,0
2.1,judo,0,0,0,0
1.55,judo,0,0,0,0
1.85,modern pentathlon,1,0,0,1
1.78,modern pentathlon,0,0,1,1
1.8,modern pentathlon,0,0,1,1
1.92,modern pentathlon,0,1,0,1
1.68,modern pentathlon,1,0,0,1
1.82,modern pentathlon,0,1,0,1
1.65,modern pentathlon,0,0,0,0
1.7,modern pentathlon,0,0,0,0
1.77,modern pentathlon,0,0,0,0
1.59,modern pentathlon,0,0,0,0
1.81,modern pentathlon,0,0,0,0
1.88,modern pentathlon,0,0,0,0
1.87,modern pentathlon,0,0,0,0
1.69,modern pentathlon,0,0,0,0
1.73,modern pentathlon,0,0,0,0
1.6,modern pentathlon,0,0,0,0
1.67,modern pentathlon,0,0,0,0
1.75,modern pentathlon,0,0,0,0
1.72,modern pentathlon,0,0,0,0
1.84,modern pentathlon,0,0,0,0
1.66,modern pentathlon,0,0,0,0
1.94,modern pentathlon,0,0,0,0
1.86,modern pentathlon,0,0,0,0
1.63,modern pentathlon,0,0,0,0
1.76,modern pentathlon,0,0,0,0
1.83,modern pentathlon,0,0,0,0
1.64,modern pentathlon,0,0,0,0
1.79,modern pentathlon,0,0,0,0
1.97,modern pentathlon,0,0,0,0
1.74,modern pentathlon,0,0,0,0
1.83,rowing,4,4,3,11
1.95,rowing,4,2,3,9
1.73,rowing,4,2,2,8
1.9,rowing,2,3,2,7
1.87,rowing,2,2,3,7
1.88,rowing,4,1,1,6
1.86,rowing,2,0,4,6
1.98,rowing,3,0,2,5
1.84,rowing,0,2,3,5
1.93,rowing,1,4,0,5
1.81,rowing,4,1,0,5
1.72,rowing,1,3,0,4
1.99,rowing,1,0,3,4
1.8,rowing,1,0,3,4
1.82,rowing,1,2,1,4
1.97,rowing,1,0,3,4
1.94,rowing,1,2,1,4
1.85,rowing,1,2,1,4
1.96,rowing,1,2,1,4
1.78,rowing,1,2,1,4
1.91,rowing,0,3,0,3
1.77,rowing,1,1,1,3
1.89,rowing,1,1,1,3
1.65,rowing,0,2,0,2
2,rowing,1,1,0,2
1.76,rowing,0,1,1,2
1.74,rowing,1,0,1,2
1.79,rowing,0,2,0,2
2.02,rowing,1,1,0,2
1.7,rowing,0,1,1,2
1.5,rowing,0,0,1,1
1.92,rowing,1,0,0,1
1.75,rowing,1,0,0,1
2.01,rowing,0,0,1,1
2.07,rowing,1,0,0,1
1.69,rowing,0,1,0,1
1.63,rowing,1,0,0,1
2.09,rowing,0,0,0,0
1.61,rowing,0,0,0,0
1.66,rowing,0,0,0,0
1.68,rowing,0,0,0,0
1.62,rowing,0,0,0,0
2.05,rowing,0,0,0,0
1.67,rowing,0,0,0,0
2.03,rowing,0,0,0,0
2.04,rowing,0,0,0,0
1.71,rowing,0,0,0,0
1.53,rowing,0,0,0,0
1.6,rowing,0,0,0,0
1.59,rowing,0,0,0,0
1.52,rowing,0,0,0,0
1.8,rugby sevens,2,3,2,7
1.72,rugby sevens,2,1,2,5
1.74,rugby sevens,2,1,2,5
1.68,rugby sevens,3,1,0,4
1.69,rugby sevens,2,2,0,4
1.65,rugby sevens,1,1,1,3
1.75,rugby sevens,0,0,3,3
1.7,rugby sevens,1,0,2,3
1.73,rugby sevens,1,1,1,3
1.77,rugby sevens,0,2,1,3
1.63,rugby sevens,0,1,1,2
1.78,rugby sevens,0,1,1,2
1.92,rugby sevens,2,0,0,2
1.9,rugby sevens,1,1,0,2
1.79,rugby sevens,0,0,2,2
1.76,rugby sevens,0,2,0,2
1.71,rugby sevens,1,1,0,2
1.95,rugby sevens,1,1,0,2
1.88,rugby sevens,0,0,2,2
1.89,rugby sevens,1,1,0,2
1.86,rugby sevens,2,0,0,2
1.83,rugby sevens,0,1,0,1
1.93,rugby sevens,0,0,1,1
1.82,rugby sevens,0,0,1,1
1.67,rugby sevens,1,0,0,1
1.81,rugby sevens,0,1,0,1
1.62,rugby sevens,0,0,1,1
1.96,rugby sevens,1,0,0,1
1.98,rugby sevens,1,0,0,1
1.91,rugby sevens,0,1,0,1
1.66,rugby sevens,0,1,0,1
1.59,rugby sevens,0,0,1,1
1.58,rugby sevens,0,0,1,1
1.57,rugby sevens,0,0,0,0
1.53,rugby sevens,0,0,0,0
1.94,rugby sevens,0,0,0,0
1.64,rugby sevens,0,0,0,0
1.84,rugby sevens,0,0,0,0
1.55,rugby sevens,0,0,0,0
2.03,rugby sevens,0,0,0,0
1.56,rugby sevens,0,0,0,0
1.6,rugby sevens,0,0,0,0
1.54,rugby sevens,0,0,0,0
1.85,rugby sevens,0,0,0,0
1.61,rugby sevens,0,0,0,0
1.87,rugby sevens,0,0,0,0
1.73,sailing,1,2,1,4
1.84,sailing,1,1,1,3
1.7,sailing,0,0,3,3
1.8,sailing,1,1,1,3
1.86,sailing,1,1,1,3
1.89,sailing,1,1,0,2
1.68,sailing,1,1,0,2
1.85,sailing,0,1,1,2
1.81,sailing,1,0,1,2
1.79,sailing,0,1,1,2
1.72,sailing,1,1,0,2
1.78,sailing,0,2,0,2
1.83,sailing,1,0,1,2
1.57,sailing,1,0,0,1
1.97,sailing,1,0,0,1
1.64,sailing,1,0,0,1
1.58,sailing,0,1,0,1
1.91,sailing,0,0,1,1
1.69,sailing,1,0,0,1
1.77,sailing,1,0,0,1
1.93,sailing,0,1,0,1
1.67,sailing,0,0,1,1
1.71,sailing,0,1,0,1
1.76,sailing,1,0,0,1
1.59,sailing,0,0,1,1
1.66,sailing,0,0,1,1
1.56,sailing,0,0,0,0
1.52,sailing,0,0,0,0
1.88,sailing,0,0,0,0
1.61,sailing,0,0,0,0
1.9,sailing,0,0,0,0
1.92,sailing,0,0,0,0
1.54,sailing,0,0,0,0
1.63,sailing,0,0,0,0
1.75,sailing,0,0,0,0
1.95,sailing,0,0,0,0
1.74,sailing,0,0,0,0
1.94,sailing,0,0,0,0
1.82,sailing,0,0,0,0
2.04,sailing,0,0,0,0
2,sailing,0,0,0,0
1.65,sailing,0,0,0,0
1.55,sailing,0,0,0,0
1.6,sailing,0,0,0,0
1.87,sailing,0,0,0,0
1.75,shooting,4,1,1,6
1.76,shooting,2,2,0,4
1.78,shooting,1,2,1,4
1.7,shooting,0,2,1,3
1.62,shooting,2,1,0,3
1.73,shooting,0,1,2,3
1.72,shooting,1,0,2,3
1.79,shooting,1,0,1,2
1.71,shooting,0,1,1,2
1.77,shooting,2,0,0,2
1.8,shooting,0,0,1,1
1.68,shooting,0,0,1,1
1.84,shooting,1,0,0,1
1.65,shooting,0,0,1,1
1.89,shooting,0,1,0,1
1.69,shooting,0,1,0,1
1.81,shooting,0,1,0,1
1.58,shooting,0,1,0,1
1.67,shooting,0,0,1,1
1.83,shooting,0,0,1,1
1.64,shooting,0,1,0,1
1.55,shooting,1,0,0,1
1.63,shooting,0,0,1,1
1.92,shooting,0,0,0,0
2.02,shooting,0,0,0,0
2,shooting,0,0,0,0
1.85,shooting,0,0,0,0
1.56,shooting,0,0,0,0
1.93,shooting,0,0,0,0
1.98,shooting,0,0,0,0
1.57,shooting,0,0,0,0
1.97,shooting,0,0,0,0
1.6,shooting,0,0,0,0
1.91,shooting,0,0,0,0
1.82,shooting,0,0,0,0
1.51,shooting,0,0,0,0
1.86,shooting,0,0,0,0
1.66,shooting,0,0,0,0
1.49,shooting,0,0,0,0
1.74,shooting,0,0,0,0
1.9,shooting,0,0,0,0
1.61,shooting,0,0,0,0
1.59,shooting,0,0,0,0
1.87,shooting,0,0,0,0
1.88,shooting,0,0,0,0
1.95,shooting,0,0,0,0
1.74,table tennis,1,1,0,2
1.78,table tennis,1,1,0,2
1.7,table tennis,0,1,1,2
1.71,table tennis,2,0,0,2
1.75,table tennis,2,0,0,2
1.72,table tennis,0,1,1,2
1.68,table tennis,0,1,0,1
1.77,table tennis,0,1,0,1
1.81,table tennis,0,0,1,1
1.8,table tennis,1,0,0,1
1.61,table tennis,0,0,1,1
1.56,table tennis,0,0,1,1
1.62,table tennis,0,1,0,1
1.65,table tennis,0,1,0,1
1.86,table tennis,0,0,1,1
1.5,table tennis,0,0,1,1
1.6,table tennis,1,0,0,1
1.58,table tennis,0,0,1,1
1.84,table tennis,0,0,0,0
1.59,table tennis,0,0,0,0
1.55,table tennis,0,0,0,0
1.49,table tennis,0,0,0,0
1.93,table tennis,0,0,0,0
1.63,table tennis,0,0,0,0
1.87,table tennis,0,0,0,0
1.67,table tennis,0,0,0,0
1.64,table tennis,0,0,0,0
1.66,table tennis,0,0,0,0
1.91,table tennis,0,0,0,0
1.98,table tennis,0,0,0,0
1.79,table tennis,0,0,0,0
1.89,table tennis,0,0,0,0
1.82,table tennis,0,0,0,0
1.76,table tennis,0,0,0,0
1.69,table tennis,0,0,0,0
1.92,table tennis,0,0,0,0
1.96,table tennis,0,0,0,0
1.73,table tennis,0,0,0,0
1.83,table tennis,0,0,0,0
1.85,table tennis,0,0,0,0
1.57,table tennis,0,0,0,0
1.85,taekwondo,0,1,2,3
1.82,taekwondo,1,0,2,3
1.76,taekwondo,0,2,1,3
1.78,taekwondo,1,0,1,2
1.88,taekwondo,2,0,0,2
1.9,taekwondo,0,0,2,2
1.83,taekwondo,0,0,2,2
1.73,taekwondo,0,1,1,2
1.67,taekwondo,1,0,0,1
1.74,taekwondo,0,0,1,1
1.99,taekwondo,0,0,1,1
1.81,taekwondo,0,1,0,1
2,taekwondo,1,0,0,1
1.64,taekwondo,1,0,0,1
2.07,taekwondo,0,1,0,1
1.65,taekwondo,0,0,1,1
1.72,taekwondo,0,1,0,1
1.91,taekwondo,0,1,0,1
1.8,taekwondo,0,0,1,1
1.97,taekwondo,0,0,1,1
1.98,taekwondo,0,0,0,0
1.75,taekwondo,0,0,0,0
1.63,taekwondo,0,0,0,0
1.61,taekwondo,0,0,0,0
1.59,taekwondo,0,0,0,0
2.02,taekwondo,0,0,0,0
1.79,taekwondo,0,0,0,0
1.7,taekwondo,0,0,0,0
1.84,taekwondo,0,0,0,0
1.6,taekwondo,0,0,0,0
1.92,taekwondo,0,0,0,0
2.03,taekwondo,0,0,0,0
1.96,taekwondo,0,0,0,0
1.71,taekwondo,0,0,0,0
1.93,taekwondo,0,0,0,0
1.87,taekwondo,0,0,0,0
1.86,taekwondo,0,0,0,0
1.77,taekwondo,0,0,0,0
1.69,taekwondo,0,0,0,0
1.68,taekwondo,0,0,0,0
1.86,tennis,0,1,1,2
1.88,tennis,1,0,1,2
1.91,tennis,1,0,1,2
1.68,tennis,2,0,0,2
1.78,tennis,0,0,2,2
1.74,tennis,1,0,0,1
1.85,tennis,1,0,0,1
1.81,tennis,0,0,1,1
1.65,tennis,0,0,1,1
1.92,tennis,0,1,0,1
1.98,tennis,0,1,0,1
1.8,tennis,1,0,0,1
1.77,tennis,0,0,1,1
1.7,tennis,0,1,0,1
1.73,tennis,0,1,0,1
1.82,tennis,0,1,0,1
1.71,tennis,0,1,0,1
1.76,tennis,1,0,0,1
1.93,tennis,0,0,0,0
1.75,tennis,0,0,0,0
1.6,tennis,0,0,0,0
1.9,tennis,0,0,0,0
2,tennis,0,0,0,0
1.67,tennis,0,0,0,0
1.66,tennis,0,0,0,0
1.89,tennis,0,0,0,0
1.84,tennis,0,0,0,0
1.62,tennis,0,0,0,0
1.63,tennis,0,0,0,0
1.64,tennis,0,0,0,0
1.72,tennis,0,0,0,0
1.83,tennis,0,0,0,0
1.95,tennis,0,0,0,0
1.69,tennis,0,0,0,0
1.96,tennis,0,0,0,0
1.79,tennis,0,0,0,0
1.87,tennis,0,0,0,0
2.04,tennis,0,0,0,0
1.59,tennis,0,0,0,0
1.94,tennis,0,0,0,0
1.7,triathlon,0,0,1,1
1.84,triathlon,1,0,0,1
1.81,triathlon,0,1,0,1
1.68,triathlon,0,0,1,1
1.78,triathlon,1,0,0,1
1.66,triathlon,0,1,0,1
1.53,triathlon,0,0,0,0
1.79,triathlon,0,0,0,0
1.83,triathlon,0,0,0,0
1.82,triathlon,0,0,0,0
1.67,triathlon,0,0,0,0
1.73,triathlon,0,0,0,0
1.91,triathlon,0,0,0,0
1.9,triathlon,0,0,0,0
1.86,triathlon,0,0,0,0
1.64,triathlon,0,0,0,0
1.85,triathlon,0,0,0,0
1.72,triathlon,0,0,0,0
1.8,triathlon,0,0,0,0
1.71,triathlon,0,0,0,0
1.69,triathlon,0,0,0,0
1.57,triathlon,0,0,0,0
1.61,triathlon,0,0,0,0
1.65,triathlon,0,0,0,0
1.55,triathlon,0,0,0,0
1.88,triathlon,0,0,0,0
1.87,triathlon,0,0,0,0
1.6,triathlon,0,0,0,0
1.75,triathlon,0,0,0,0
1.76,triathlon,0,0,0,0
1.63,triathlon,0,0,0,0
1.77,triathlon,0,0,0,0
1.74,triathlon,0,0,0,0
1.98,volleyball,1,3,3,7
1.88,volleyball,1,0,6,7
1.93,volleyball,1,2,2,5
1.9,volleyball,2,2,1,5
1.85,volleyball,3,2,0,5
1.86,volleyball,1,2,1,4
1.8,volleyball,1,1,1,3
1.96,volleyball,1,1,1,3
1.92,volleyball,2,1,0,3
2.05,volleyball,1,0,2,3
1.95,volleyball,3,0,0,3
2.02,volleyball,0,1,2,3
1.84,volleyball,1,0,2,3
2.01,volleyball,1,0,1,2
2.03,volleyball,1,0,1,2
2.09,volleyball,2,0,0,2
2.04,volleyball,0,2,0,2
2,volleyball,0,2,0,2
1.94,volleyball,0,1,1,2
1.99,volleyball,2,0,0,2
2.07,volleyball,1,0,1,2
1.91,volleyball,0,1,1,2
1.82,volleyball,1,1,0,2
1.83,volleyball,0,1,0,1
1.7,volleyball,0,0,1,1
1.87,volleyball,0,1,0,1
2.06,volleyball,0,1,0,1
1.77,volleyball,0,1,0,1
2.08,volleyball,0,1,0,1
1.71,volleyball,1,0,0,1
1.81,volleyball,1,0,0,1
1.78,volleyball,0,0,1,1
1.66,volleyball,0,0,0,0
1.97,volleyball,0,0,0,0
1.89,volleyball,0,0,0,0
1.59,volleyball,0,0,0,0
1.75,volleyball,0,0,0,0
1.74,volleyball,0,0,0,0
1.76,volleyball,0,0,0,0
2.1,volleyball,0,0,0,0
1.73,volleyball,0,0,0,0
1.72,volleyball,0,0,0,0
2.11,volleyball,0,0,0,0
1.79,volleyball,0,0,0,0
1.69,volleyball,0,0,0,0
1.63,volleyball,0,0,0,0
1.65,volleyball,0,0,0,0
1.64,volleyball,0,0,0,0
1.68,volleyball,0,0,0,0
1.59,weightlifting,2,1,1,4
1.65,weightlifting,0,1,2,3
1.7,weightlifting,1,2,0,3
1.6,weightlifting,1,0,2,3
1.55,weightlifting,1,1,1,3
1.72,weightlifting,0,2,1,3
1.73,weightlifting,1,1,0,2
1.8,weightlifting,0,1,1,2
1.54,weightlifting,1,1,0,2
1.5,weightlifting,1,0,0,1
1.97,weightlifting,1,0,0,1
1.49,weightlifting,0,1,0,1
1.78,weightlifting,0,0,1,1
1.74,weightlifting,0,0,1,1
1.68,weightlifting,1,0,0,1
1.81,weightlifting,0,1,0,1
1.51,weightlifting,0,1,0,1
1.58,weightlifting,0,0,1,1
1.63,weightlifting,1,0,0,1
1.82,weightlifting,0,0,1,1
1.47,weightlifting,0,1,0,1
1.83,weightlifting,1,0,0,1
1.62,weightlifting,1,0,0,1
1.52,weightlifting,0,1,0,1
1.45,weightlifting,0,0,1,1
1.77,weightlifting,1,0,0,1
1.76,weightlifting,1,0,0,1
1.57,weightlifting,0,0,1,1
1.69,weightlifting,0,0,1,1
1.87,weightlifting,0,0,0,0
1.64,weightlifting,0,0,0,0
1.75,weightlifting,0,0,0,0
1.84,weightlifting,0,0,0,0
1.86,weightlifting,0,0,0,0
1.61,weightlifting,0,0,0,0
1.88,weightlifting,0,0,0,0
1.9,weightlifting,0,0,0,0
1.66,weightlifting,0,0,0,0
1.56,weightlifting,0,0,0,0
1.37,weightlifting,0,0,0,0
1.71,weightlifting,0,0,0,0
1.92,weightlifting,0,0,0,0
1.53,weightlifting,0,0,0,0
1.67,weightlifting,0,0,0,0
1.91,weightlifting,0,0,0,0
1.48,weightlifting,0,0,0,0
1.79,weightlifting,0,0,0,0
1.85,weightlifting,0,0,0,0
1.7,wrestling,3,1,4,8
1.6,wrestling,2,0,3,5
1.74,wrestling,1,2,1,4
1.8,wrestling,0,1,3,4
1.65,wrestling,0,1,2,3
1.81,wrestling,2,0,1,3
1.72,wrestling,0,0,3,3
1.63,wrestling,1,2,0,3
1.9,wrestling,1,1,0,2
1.77,wrestling,1,1,0,2
1.66,wrestling,1,1,0,2
1.75,wrestling,2,0,0,2
1.92,wrestling,1,0,1,2
1.64,wrestling,0,1,1,2
1.57,wrestling,0,2,0,2
1.73,wrestling,0,1,1,2
1.98,wrestling,1,0,1,2
1.83,wrestling,0,0,1,1
1.78,wrestling,0,1,0,1
1.85,wrestling,0,0,1,1
1.86,wrestling,0,1,0,1
1.88,wrestling,0,0,1,1
1.71,wrestling,0,0,1,1
1.69,wrestling,0,0,1,1
1.87,wrestling,0,0,1,1
1.82,wrestling,0,1,0,1
1.52,wrestling,1,0,0,1
1.79,wrestling,0,1,0,1
1.59,wrestling,1,0,0,1
1.62,wrestling,0,0,1,1
1.61,wrestling,0,0,1,1
1.67,wrestling,0,0,1,1
1.51,wrestling,0,0,1,1
1.58,wrestling,0,0,1,1
1.76,wrestling,0,0,1,1
1.84,wrestling,0,0,1,1
1.68,wrestling,0,0,1,1
1.56,wrestling,0,0,0,0
1.89,wrestling,0,0,0,0
1.54,wrestling,0,0,0,0
1.5,wrestling,0,0,0,0
1.91,wrestling,0,0,0,0
2.03,wrestling,0,0,0,0
1.53,wrestling,0,0,0,0
2,wrestling,0,0,0,0
1.95,wrestling,0,0,0,0
1.55,wrestling,0,0,0,0
1.93,wrestling,0,0,0,0
