weight,sport,gold,silver,bronze,total
72,aquatics,9,7,3,19
90,aquatics,10,4,4,18
68,aquatics,6,5,6,17
74,aquatics,6,6,1,13
60,aquatics,3,5,5,13
61,aquatics,2,4,6,12
56,aquatics,4,0,7,11
64,aquatics,3,4,3,10
77,aquatics,2,5,3,10
62,aquatics,1,5,4,10
58,aquatics,3,4,3,10
88,aquatics,6,1,2,9
75,aquatics,0,4,4,8
65,aquatics,5,2,1,8
67,aquatics,2,2,3,7
70,aquatics,2,2,3,7
59,aquatics,1,2,4,7
86,aquatics,5,1,1,7
79,aquatics,2,1,3,6
84,aquatics,1,4,1,6
95,aquatics,1,1,4,6
76,aquatics,1,4,1,6
102,aquatics,2,0,4,6
48,aquatics,2,0,3,5
85,aquatics,0,3,2,5
92,aquatics,2,2,1,5
87,aquatics,0,3,2,5
52,aquatics,2,2,1,5
69,aquatics,2,1,2,5
54,aquatics,2,1,2,5
53,aquatics,1,1,2,4
73,aquatics,1,1,2,4
71,aquatics,1,1,2,4
93,aquatics,2,1,1,4
83,aquatics,2,2,0,4
89,aquatics,3,1,0,4
80,aquatics,2,2,0,4
55,aquatics,2,1,1,4
78,aquatics,2,2,0,4
99,aquatics,0,3,0,3
97,aquatics,2,0,1,3
66,aquatics,0,2,1,3
49,aquatics,3,0,0,3
50,aquatics,1,0,2,3
115,aquatics,0,2,0,2
100,aquatics,1,0,1,2
96,aquatics,1,0,1,2
98,aquatics,1,0,1,2
81,aquatics,1,0,1,2
106,aquatics,1,1,0,2
91,aquatics,2,0,0,2
104,aquatics,1,0,0,1
109,aquatics,0,1,0,1
51,aquatics,0,1,0,1
82,aquatics,0,0,1,1
101,aquatics,1,0,0,1
105,aquatics,1,0,0,1
57,aquatics,0,1,0,1
103,aquatics,0,1,0,1
46,aquatics,0,1,0,1
47,aquatics,0,0,0,0
113,aquatics,0,0,0,0
45,aquatics,0,0,0,0
120,aquatics,0,0,0,0
110,aquatics,0,0,0,0
39,aquatics,0,0,0,0
107,aquatics,0,0,0,0
125,aquatics,0,0,0,0
108,aquatics,0,0,0,0
40,aquatics,0,0,0,0
63,aquatics,0,0,0,0
118,aquatics,0,0,0,0
130,aquatics,0,0,0,0
94,aquatics,0,0,0,0
57,archery,1,1,1,3
63,archery,0,2,1,3
86,archery,0,1,1,2
84,archery,2,0,0,2
77,archery,0,1,1,2
53,archery,1,0,1,2
50,archery,2,0,0,2
70,archery,0,1,0,1
102,archery,0,0,1,1
80,archery,1,0,0,1
60,archery,0,0,1,1
68,archery,0,1,0,1
83,archery,0,1,0,1
69,archery,0,0,1,1
95,archery,1,0,0,1
72,archery,0,0,0,0
89,archery,0,0,0,0
65,archery,0,0,0,0
76,archery,0,0,0,0
90,archery,0,0,0,0
75,archery,0,0,0,0
55,archery,0,0,0,0
42,archery,0,0,0,0
51,archery,0,0,0,0
73,archery,0,0,0,0
64,archery,0,0,0,0
52,archery,0,0,0,0
61,archery,0,0,0,0
115,archery,0,0,0,0
46,archery,0,0,0,0
79,archery,0,0,0,0
74,archery,0,0,0,0
48,archery,0,0,0,0
81,archery,0,0,0,0
87,archery,0,0,0,0
58,archery,0,0,0,0
98,archery,0,0,0,0
59,archery,0,0,0,0
105,archery,0,0,0,0
82,archery,0,0,0,0
96,archery,0,0,0,0
56,archery,0,0,0,0
130,archery,0,0,0,0
92,archery,0,0,0,0
78,archery,0,0,0,0
66,archery,0,0,0,0
88,archery,0,0,0,0
58,athletics,8,4,4,16
57,athletics,3,7,1,11
70,athletics,4,3,4,11
72,athletics,4,4,1,9
80,athletics,1,3,3,7
68,athletics,2,1,2,5
74,athletics,2,1,2,5
55,athletics,2,2,1,5
65,athletics,1,3,1,5
95,athletics,4,0,1,5
85,athletics,3,1,1,5
61,athletics,0,2,3,5
81,athletics,3,1,0,4
71,athletics,1,1,2,4
60,athletics,1,1,2,4
75,athletics,1,0,3,4
62,athletics,0,1,3,4
56,athletics,2,1,1,4
67,athletics,0,3,1,4
47,athletics,1,2,1,4
120,athletics,1,1,1,3
77,athletics,0,2,1,3
76,athletics,1,0,2,3
64,athletics,0,1,2,3
45,athletics,1,0,2,3
50,athletics,1,1,1,3
86,athletics,2,0,1,3
69,athletics,1,1,0,2
51,athletics,1,1,0,2
40,athletics,1,1,0,2
59,athletics,1,0,1,2
53,athletics,0,1,1,2
54,athletics,1,0,1,2
92,athletics,1,0,1,2
84,athletics,1,1,0,2
83,athletics,1,0,1,2
66,athletics,0,1,1,2
79,athletics,0,0,2,2
133,athletics,0,1,0,1
128,athletics,0,0,1,1
88,athletics,1,0,0,1
63,athletics,0,1,0,1
93,athletics,1,0,0,1
90,athletics,0,0,1,1
73,athletics,1,0,0,1
124,athletics,1,0,0,1
125,athletics,0,0,1,1
42,athletics,0,1,0,1
94,athletics,0,1,0,1
136,athletics,1,0,0,1
105,athletics,0,1,0,1
49,athletics,0,1,0,1
130,athletics,0,1,0,1
123,athletics,1,0,0,1
52,athletics,0,1,0,1
110,athletics,0,1,0,1
43,athletics,1,0,0,1
145,athletics,0,0,0,0
117,athletics,0,0,0,0
108,athletics,0,0,0,0
91,athletics,0,0,0,0
104,athletics,0,0,0,0
132,athletics,0,0,0,0
155,athletics,0,0,0,0
101,athletics,0,0,0,0
135,athletics,0,0,0,0
127,athletics,0,0,0,0
138,athletics,0,0,0,0
89,athletics,0,0,0,0
154,athletics,0,0,0,0
113,athletics,0,0,0,0
99,athletics,0,0,0,0
46,athletics,0,0,0,0
97,athletics,0,0,0,0
142,athletics,0,0,0,0
82,athletics,0,0,0,0
98,athletics,0,0,0,0
144,athletics,0,0,0,0
122,athletics,0,0,0,0
44,athletics,0,0,0,0
100,athletics,0,0,0,0
48,athletics,0,0,0,0
102,athletics,0,0,0,0
41,athletics,0,0,0,0
140,athletics,0,0,0,0
126,athletics,0,0,0,0
106,athletics,0,0,0,0
160,athletics,0,0,0,0
115,athletics,0,0,0,0
87,athletics,0,0,0,0
134,athletics,0,0,0,0
39,athletics,0,0,0,0
112,athletics,0,0,0,0
139,athletics,0,0,0,0
114,athletics,0,0,0,0
119,athletics,0,0,0,0
96,athletics,0,0,0,0
111,athletics,0,0,0,0
78,athletics,0,0,0,0
150,athletics,0,0,0,0
116,athletics,0,0,0,0
118,athletics,0,0,0,0
165,athletics,0,0,0,0
157,athletics,0,0,0,0
103,athletics,0,0,0,0
68,badminton,0,3,0,3
70,badminton,0,1,1,2
65,badminton,1,1,0,2
75,badminton,1,0,1,2
60,badminton,1,0,1,2
72,badminton,1,0,0,1
80,badminton,0,0,1,1
59,badminton,0,0,1,1
62,badminton,1,0,0,1
51,badminton,0,0,1,1
71,badminton,0,1,0,1
77,badminton,0,1,0,1
56,badminton,0,1,0,1
50,badminton,1,0,0,1
88,badminton,0,0,1,1
81,badminton,1,0,0,1
78,badminton,1,0,0,1
83,badminton,0,0,0,0
90,badminton,0,0,0,0
93,badminton,0,0,0,0
85,badminton,0,0,0,0
79,badminton,0,0,0,0
54,badminton,0,0,0,0
57,badminton,0,0,0,0
52,badminton,0,0,0,0
58,badminton,0,0,0,0
63,badminton,0,0,0,0
82,badminton,0,0,0,0
64,badminton,0,0,0,0
69,badminton,0,0,0,0
55,badminton,0,0,0,0
61,badminton,0,0,0,0
86,badminton,0,0,0,0
73,badminton,0,0,0,0
76,badminton,0,0,0,0
92,badminton,0,0,0,0
74,badminton,0,0,0,0
67,badminton,0,0,0,0
66,badminton,0,0,0,0
84,badminton,0,0,0,0
90,basketball,1,3,1,5
99,basketball,3,1,0,4
72,basketball,1,1,2,4
115,basketball,0,1,2,3
93,basketball,1,1,1,3
104,basketball,2,1,0,3
70,basketball,2,0,1,3
107,basketball,0,1,1,2
109,basketball,1,0,1,2
84,basketball,0,0,2,2
74,basketball,1,1,0,2
94,basketball,1,1,0,2
77,basketball,1,0,1,2
102,basketball,1,1,0,2
68,basketball,0,2,0,2
82,basketball,0,0,2,2
60,basketball,0,1,1,2
79,basketball,2,0,0,2
96,basketball,0,2,0,2
87,basketball,1,0,0,1
64,basketball,0,1,0,1
130,basketball,0,1,0,1
86,basketball,1,0,0,1
73,basketball,0,0,1,1
122,basketball,1,0,0,1
76,basketball,0,0,1,1
120,basketball,1,0,0,1
112,basketball,0,1,0,1
83,basketball,0,0,1,1
78,basketball,0,1,0,1
91,basketball,0,0,1,1
75,basketball,0,0,1,1
62,basketball,0,1,0,1
71,basketball,0,1,0,1
80,basketball,0,0,1,1
100,basketball,0,0,1,1
65,basketball,0,0,1,1
69,basketball,0,1,0,1
97,basketball,1,0,0,1
88,basketball,1,0,0,1
66,basketball,1,0,0,1
63,basketball,0,0,1,1
61,basketball,0,0,0,0
106,basketball,0,0,0,0
58,basketball,0,0,0,0
57,basketball,0,0,0,0
121,basketball,0,0,0,0
85,basketball,0,0,0,0
114,basketball,0,0,0,0
95,basketball,0,0,0,0
118,basketball,0,0,0,0
113,basketball,0,0,0,0
110,basketball,0,0,0,0
125,basketball,0,0,0,0
108,basketball,0,0,0,0
103,basketball,0,0,0,0
92,basketball,0,0,0,0
137,basketball,0,0,0,0
117,basketball,0,0,0,0
98,basketball,0,0,0,0
105,basketball,0,0,0,0
67,basketball,0,0,0,0
89,basketball,0,0,0,0
53,basketball,0,0,0,0
63,canoe,4,1,3,8
85,canoe,2,2,3,7
70,canoe,0,6,1,7
90,canoe,3,1,3,7
68,canoe,0,3,2,5
80,canoe,1,2,2,5
78,canoe,2,2,1,5
95,canoe,1,1,1,3
76,canoe,2,1,0,3
89,canoe,1,1,1,3
93,canoe,1,1,0,2
62,canoe,2,0,0,2
98,canoe,1,0,1,2
75,canoe,0,0,2,2
82,canoe,1,0,1,2
115,canoe,0,1,1,2
81,canoe,1,1,0,2
92,canoe,2,0,0,2
88,canoe,1,1,0,2
67,canoe,0,0,2,2
55,canoe,1,0,0,1
94,canoe,0,1,0,1
83,canoe,0,1,0,1
60,canoe,0,0,1,1
69,canoe,0,0,1,1
64,canoe,1,0,0,1
79,canoe,0,0,1,1
65,canoe,0,0,1,1
73,canoe,0,1,0,1
87,canoe,0,0,0,0
71,canoe,0,0,0,0
97,canoe,0,0,0,0
100,canoe,0,0,0,0
59,canoe,0,0,0,0
99,canoe,0,0,0,0
50,canoe,0,0,0,0
57,canoe,0,0,0,0
72,canoe,0,0,0,0
77,canoe,0,0,0,0
56,canoe,0,0,0,0
58,canoe,0,0,0,0
54,canoe,0,0,0,0
61,canoe,0,0,0,0
102,canoe,0,0,0,0
96,canoe,0,0,0,0
66,canoe,0,0,0,0
74,canoe,0,0,0,0
86,canoe,0,0,0,0
91,canoe,0,0,0,0
84,canoe,0,0,0,0
65,cycling,1,3,4,8
56,cycling,4,1,1,6
70,cycling,2,2,1,5
66,cycling,1,3,1,5
82,cycling,2,1,1,4
93,cycling,1,3,0,4
81,cycling,4,0,0,4
77,cycling,0,3,1,4
69,cycling,1,1,2,4
73,cycling,1,0,3,4
90,cycling,1,1,1,3
74,cycling,1,1,1,3
62,cycling,1,1,1,3
64,cycling,0,1,1,2
50,cycling,1,0,1,2
54,cycling,0,2,0,2
58,cycling,1,0,1,2
61,cycling,0,0,2,2
80,cycling,0,1,1,2
67,cycling,0,0,2,2
88,cycling,1,0,1,2
78,cycling,1,0,0,1
72,cycling,0,0,1,1
100,cycling,0,0,1,1
68,cycling,1,0,0,1
63,cycling,0,1,0,1
59,cycling,0,0,1,1
83,cycling,0,1,0,1
55,cycling,1,0,0,1
79,cycling,1,0,0,1
76,cycling,0,1,0,1
45,cycling,0,0,0,0
52,cycling,0,0,0,0
47,cycling,0,0,0,0
87,cycling,0,0,0,0
71,cycling,0,0,0,0
85,cycling,0,0,0,0
60,cycling,0,0,0,0
96,cycling,0,0,0,0
95,cycling,0,0,0,0
49,cycling,0,0,0,0
92,cycling,0,0,0,0
51,cycling,0,0,0,0
75,cycling,0,0,0,0
53,cycling,0,0,0,0
89,cycling,0,0,0,0
97,cycling,0,0,0,0
48,cycling,0,0,0,0
46,cycling,0,0,0,0
86,cycling,0,0,0,0
57,cycling,0,0,0,0
70,equestrian,5,3,1,9
80,equestrian,1,1,2,4
57,equestrian,1,2,0,3
54,equestrian,1,0,2,3
65,equestrian,0,2,1,3
58,equestrian,0,1,2,3
63,equestrian,2,1,0,3
76,equestrian,1,0,1,2
73,equestrian,1,0,1,2
55,equestrian,1,1,0,2
68,equestrian,0,0,2,2
66,equestrian,1,1,0,2
71,equestrian,0,0,1,1
85,equestrian,0,0,1,1
75,equestrian,0,1,0,1
51,equestrian,0,0,1,1
86,equestrian,0,1,0,1
60,equestrian,1,0,0,1
83,equestrian,0,1,0,1
88,equestrian,0,0,0,0
61,equestrian,0,0,0,0
77,equestrian,0,0,0,0
78,equestrian,0,0,0,0
82,equestrian,0,0,0,0
69,equestrian,0,0,0,0
50,equestrian,0,0,0,0
89,equestrian,0,0,0,0
62,equestrian,0,0,0,0
47,equestrian,0,0,0,0
79,equestrian,0,0,0,0
81,equestrian,0,0,0,0
52,equestrian,0,0,0,0
64,equestrian,0,0,0,0
87,equestrian,0,0,0,0
56,equestrian,0,0,0,0
84,equestrian,0,0,0,0
72,equestrian,0,0,0,0
59,equestrian,0,0,0,0
49,equestrian,0,0,0,0
74,equestrian,0,0,0,0
48,equestrian,0,0,0,0
67,equestrian,0,0,0,0
64,fencing,3,0,2,5
78,fencing,2,2,0,4
74,fencing,0,2,2,4
65,fencing,1,3,0,4
70,fencing,1,3,0,4
75,fencing,1,2,1,4
68,fencing,0,1,2,3
81,fencing,0,1,2,3
82,fencing,1,0,2,3
66,fencing,0,2,1,3
79,fencing,1,0,2,3
56,fencing,1,0,1,2
83,fencing,1,0,1,2
58,fencing,1,0,1,2
63,fencing,0,1,1,2
62,fencing,1,0,1,2
76,fencing,0,2,0,2
77,fencing,0,1,0,1
53,fencing,1,0,0,1
100,fencing,1,0,0,1
80,fencing,0,1,0,1
72,fencing,0,0,1,1
71,fencing,1,0,0,1
90,fencing,0,0,1,1
50,fencing,0,1,0,1
85,fencing,0,0,1,1
73,fencing,1,0,0,1
84,fencing,1,0,0,1
60,fencing,1,0,0,1
61,fencing,1,0,0,1
45,fencing,0,0,0,0
98,fencing,0,0,0,0
102,fencing,0,0,0,0
59,fencing,0,0,0,0
55,fencing,0,0,0,0
51,fencing,0,0,0,0
93,fencing,0,0,0,0
69,fencing,0,0,0,0
67,fencing,0,0,0,0
54,fencing,0,0,0,0
48,fencing,0,0,0,0
46,fencing,0,0,0,0
87,fencing,0,0,0,0
57,fencing,0,0,0,0
88,fencing,0,0,0,0
89,fencing,0,0,0,0
52,fencing,0,0,0,0
94,fencing,0,0,0,0
96,fencing,0,0,0,0
86,fencing,0,0,0,0
91,fencing,0,0,0,0
68,football,5,1,2,8
65,football,3,2,2,7
69,football,4,1,1,6
80,football,2,3,0,5
63,football,0,1,4,5
71,football,3,0,1,4
60,football,1,2,1,4
66,football,0,2,1,3
64,football,1,2,0,3
55,football,2,0,1,3
62,football,1,1,1,3
75,football,2,1,0,3
77,football,0,2,1,3
74,football,0,2,0,2
82,football,0,2,0,2
56,football,2,0,0,2
67,football,0,1,1,2
58,football,1,0,1,2
76,football,0,2,0,2
70,football,2,0,0,2
84,football,0,2,0,2
54,football,1,1,0,2
59,football,1,1,0,2
89,football,0,1,0,1
86,football,1,0,0,1
73,football,0,1,0,1
87,football,0,1,0,1
57,football,1,0,0,1
52,football,1,0,0,1
100,football,0,1,0,1
78,football,0,1,0,1
72,football,0,1,0,1
79,football,1,0,0,1
53,football,0,0,1,1
88,football,0,1,0,1
61,football,1,0,0,1
49,football,0,0,0,0
48,football,0,0,0,0
81,football,0,0,0,0
50,football,0,0,0,0
85,football,0,0,0,0
47,football,0,0,0,0
95,football,0,0,0,0
83,football,0,0,0,0
91,football,0,0,0,0
96,football,0,0,0,0
90,golf,0,1,0,1
65,golf,0,1,0,1
86,golf,0,0,1,1
89,golf,1,0,0,1
85,golf,0,0,1,1
60,golf,1,0,0,1
82,golf,0,0,0,0
66,golf,0,0,0,0
64,golf,0,0,0,0
76,golf,0,0,0,0
78,golf,0,0,0,0
80,golf,0,0,0,0
61,golf,0,0,0,0
87,golf,0,0,0,0
59,golf,0,0,0,0
91,golf,0,0,0,0
68,golf,0,0,0,0
70,golf,0,0,0,0
73,golf,0,0,0,0
98,golf,0,0,0,0
100,golf,0,0,0,0
62,golf,0,0,0,0
52,golf,0,0,0,0
81,golf,0,0,0,0
77,golf,0,0,0,0
50,golf,0,0,0,0
63,golf,0,0,0,0
57,golf,0,0,0,0
56,golf,0,0,0,0
88,golf,0,0,0,0
106,golf,0,0,0,0
74,golf,0,0,0,0
69,golf,0,0,0,0
75,golf,0,0,0,0
58,golf,0,0,0,0
79,golf,0,0,0,0
67,golf,0,0,0,0
72,golf,0,0,0,0
53,golf,0,0,0,0
83,golf,0,0,0,0
55,golf,0,0,0,0
48,golf,0,0,0,0
47,gymnastics,5,1,3,9
56,gymnastics,3,2,4,9
48,gymnastics,2,4,2,8
51,gymnastics,2,2,1,5
52,gymnastics,3,2,0,5
62,gymnastics,1,3,1,5
54,gymnastics,3,1,0,4
53,gymnastics,1,1,2,4
46,gymnastics,2,1,0,3
55,gymnastics,0,2,1,3
60,gymnastics,0,0,3,3
65,gymnastics,0,1,2,3
72,gymnastics,0,2,0,2
57,gymnastics,1,0,1,2
58,gymnastics,1,0,1,2
64,gymnastics,0,1,1,2
50,gymnastics,2,0,0,2
35,gymnastics,0,1,1,2
44,gymnastics,1,1,0,2
68,gymnastics,1,1,0,2
49,gymnastics,1,0,1,2
59,gymnastics,0,1,0,1
78,gymnastics,0,1,0,1
36,gymnastics,0,0,1,1
70,gymnastics,0,0,1,1
45,gymnastics,0,1,0,1
66,gymnastics,1,0,0,1
34,gymnastics,0,0,1,1
67,gymnastics,0,1,0,1
37,gymnastics,0,0,1,1
33,gymnastics,0,0,1,1
61,gymnastics,0,0,1,1
75,gymnastics,0,0,0,0
81,gymnastics,0,0,0,0
41,gymnastics,0,0,0,0
40,gymnastics,0,0,0,0
43,gymnastics,0,0,0,0
77,gymnastics,0,0,0,0
71,gymnastics,0,0,0,0
31,gymnastics,0,0,0,0
63,gymnastics,0,0,0,0
69,gymnastics,0,0,0,0
74,gymnastics,0,0,0,0
42,gymnastics,0,0,0,0
105,handball,2,2,1,5
110,handball,0,1,3,4
95,handball,3,0,1,4
66,handball,1,3,0,4
100,handball,1,3,0,4
93,handball,1,2,0,3
74,handball,3,0,0,3
80,handball,1,1,0,2
92,handball,1,1,0,2
63,handball,2,0,0,2
67,handball,0,2,0,2
64,handball,0,2,0,2
94,handball,0,0,2,2
106,handball,1,0,1,2
60,handball,2,0,0,2
102,handball,2,0,0,2
69,handball,0,2,0,2
86,handball,0,2,0,2
73,handball,1,1,0,2
88,handball,1,0,1,2
65,handball,0,2,0,2
85,handball,1,0,0,1
87,handball,0,0,1,1
81,handball,1,0,0,1
72,handball,1,0,0,1
103,handball,0,0,1,1
79,handball,0,1,0,1
83,handball,0,1,0,1
98,handball,1,0,0,1
108,handball,0,1,0,1
115,handball,0,0,1,1
90,handball,0,0,1,1
104,handball,0,1,0,1
76,handball,0,1,0,1
97,handball,0,0,1,1
52,handball,0,1,0,1
68,handball,1,0,0,1
70,handball,1,0,0,1
99,handball,0,0,1,1
71,handball,1,0,0,1
118,handball,0,0,0,0
112,handball,0,0,0,0
96,handball,0,0,0,0
78,handball,0,0,0,0
58,handball,0,0,0,0
111,handball,0,0,0,0
89,handball,0,0,0,0
107,handball,0,0,0,0
62,handball,0,0,0,0
91,handball,0,0,0,0
84,handball,0,0,0,0
54,handball,0,0,0,0
114,handball,0,0,0,0
75,handball,0,0,0,0
59,handball,0,0,0,0
77,handball,0,0,0,0
82,handball,0,0,0,0
109,handball,0,0,0,0
74,hockey,4,2,2,8
69,hockey,1,3,2,6
61,hockey,1,1,3,5
58,hockey,1,1,2,4
67,hockey,1,1,2,4
56,hockey,1,1,2,4
77,hockey,2,0,2,4
63,hockey,0,3,1,4
76,hockey,2,0,2,4
75,hockey,3,1,0,4
55,hockey,2,1,1,4
66,hockey,1,2,0,3
71,hockey,0,1,2,3
81,hockey,0,2,1,3
73,hockey,2,1,0,3
62,hockey,3,0,0,3
70,hockey,1,2,0,3
64,hockey,0,2,1,3
88,hockey,1,1,1,3
83,hockey,0,0,2,2
82,hockey,2,0,0,2
65,hockey,2,0,0,2
79,hockey,1,1,0,2
80,hockey,1,0,1,2
85,hockey,0,1,1,2
78,hockey,0,2,0,2
91,hockey,1,0,0,1
84,hockey,0,1,0,1
60,hockey,0,0,1,1
54,hockey,0,1,0,1
68,hockey,0,0,1,1
72,hockey,1,0,0,1
89,hockey,0,0,1,1
95,hockey,0,0,1,1
59,hockey,0,1,0,1
87,hockey,0,0,1,1
52,hockey,0,0,0,0
53,hockey,0,0,0,0
94,hockey,0,0,0,0
57,hockey,0,0,0,0
92,hockey,0,0,0,0
93,hockey,0,0,0,0
50,hockey,0,0,0,0
45,hockey,0,0,0,0
51,hockey,0,0,0,0
48,hockey,0,0,0,0
90,hockey,0,0,0,0
66,judo,1,2,2,5
70,judo,1,1,2,4
60,judo,1,1,2,4
52,judo,1,1,2,4
48,judo,1,0,2,3
78,judo,0,1,2,3
90,judo,1,0,2,3
81,judo,1,0,2,3
57,judo,1,0,2,3
73,judo,1,1,1,3
108,judo,0,0,2,2
100,judo,0,1,1,2
63,judo,0,0,2,2
120,judo,0,0,1,1
80,judo,0,1,0,1
82,judo,0,1,0,1
59,judo,0,1,0,1
105,judo,1,0,0,1
125,judo,0,1,0,1
75,judo,0,0,1,1
160,judo,0,0,1,1
65,judo,1,0,0,1
51,judo,0,1,0,1
139,judo,1,0,0,1
128,judo,0,0,1,1
94,judo,0,1,0,1
74,judo,1,0,0,1
97,judo,1,0,0,1
68,judo,0,0,0,0
104,judo,0,0,0,0
85,judo,0,0,0,0
122,judo,0,0,0,0
130,judo,0,0,0,0
103,judo,0,0,0,0
76,judo,0,0,0,0
61,judo,0,0,0,0
46,judo,0,0,0,0
140,judo,0,0,0,0
83,judo,0,0,0,0
89,judo,0,0,0,0
148,judo,0,0,0,0
127,judo,0,0,0,0
91,judo,0,0,0,0
64,judo,0,0,0,0
110,judo,0,0,0,0
67,judo,0,0,0,0
71,judo,0,0,0,0
77,judo,0,0,0,0
124,judo,0,0,0,0
135,judo,0,0,0,0
98,judo,0,0,0,0
54,judo,0,0,0,0
101,judo,0,0,0,0
58,judo,0,0,0,0
117,judo,0,0,0,0
93,judo,0,0,0,0
69,judo,0,0,0,0
55,judo,0,0,0,0
95,judo,0,0,0,0
99,judo,0,0,0,0
132,judo,0,0,0,0
119,judo,0,0,0,0
170,judo,0,0,0,0
69,modern pentathlon,0,1,0,1
74,modern pentathlon,1,0,0,1
55,modern pentathlon,1,0,0,1
64,modern pentathlon,0,0,1,1
78,modern pentathlon,0,1,0,1
60,modern pentathlon,0,0,1,1
53,modern pentathlon,0,0,0,0
58,modern pentathlon,0,0,0,0
82,modern pentathlon,0,0,0,0
66,modern pentathlon,0,0,0,0
90,modern pentathlon,0,0,0,0
65,modern pentathlon,0,0,0,0
67,modern pentathlon,0,0,0,0
80,modern pentathlon,0,0,0,0
71,modern pentathlon,0,0,0,0
57,modern pentathlon,0,0,0,0
59,modern pentathlon,0,0,0,0
49,modern pentathlon,0,0,0,0
81,modern pentathlon,0,0,0,0
51,modern pentathlon,0,0,0,0
52,modern pentathlon,0,0,0,0
72,modern pentathlon,0,0,0,0
70,modern pentathlon,0,0,0,0
68,modern pentathlon,0,0,0,0
54,modern pentathlon,0,0,0,0
73,modern pentathlon,0,0,0,0
75,modern pentathlon,0,0,0,0
63,modern pentathlon,0,0,0,0
62,modern pentathlon,0,0,0,0
76,modern pentathlon,0,0,0,0
77,modern pentathlon,0,0,0,0
75,rowing,3,4,4,11
95,rowing,2,0,6,8
93,rowing,2,4,2,8
70,rowing,1,4,3,8
100,rowing,4,1,2,7
76,rowing,2,3,1,6
73,rowing,1,5,0,6
90,rowing,1,1,3,5
74,rowing,2,1,2,5
72,rowing,1,2,2,5
71,rowing,2,2,1,5
98,rowing,2,2,0,4
92,rowing,2,2,0,4
97,rowing,2,1,1,4
102,rowing,1,1,1,3
78,rowing,1,1,1,3
86,rowing,1,0,2,3
55,rowing,1,1,1,3
68,rowing,2,0,1,3
94,rowing,0,3,0,3
96,rowing,2,1,0,3
110,rowing,1,1,0,2
81,rowing,2,0,0,2
80,rowing,1,1,0,2
57,rowing,1,0,1,2
66,rowing,0,1,1,2
88,rowing,0,2,0,2
59,rowing,1,1,0,2
77,rowing,1,0,1,2
79,rowing,1,0,1,2
49,rowing,1,0,0,1
104,rowing,0,0,1,1
105,rowing,0,0,1,1
58,rowing,0,1,0,1
50,rowing,0,0,1,1
91,rowing,0,1,0,1
62,rowing,0,0,1,1
83,rowing,1,0,0,1
67,rowing,1,0,0,1
87,rowing,0,0,1,1
89,rowing,1,0,0,1
69,rowing,0,0,1,1
60,rowing,0,1,0,1
101,rowing,1,0,0,1
63,rowing,0,0,1,1
64,rowing,0,0,0,0
82,rowing,0,0,0,0
103,rowing,0,0,0,0
85,rowing,0,0,0,0
106,rowing,0,0,0,0
84,rowing,0,0,0,0
65,rowing,0,0,0,0
108,rowing,0,0,0,0
61,rowing,0,0,0,0
54,rowing,0,0,0,0
53,rowing,0,0,0,0
107,rowing,0,0,0,0
99,rowing,0,0,0,0
70,rugby sevens,2,3,1,6
65,rugby sevens,1,1,2,4
98,rugby sevens,3,1,0,4
81,rugby sevens,2,0,1,3
75,rugby sevens,1,1,1,3
64,rugby sevens,2,0,1,3
67,rugby sevens,1,1,1,3
105,rugby sevens,2,1,0,3
73,rugby sevens,0,1,2,3
89,rugby sevens,0,2,1,3
90,rugby sevens,1,0,1,2
87,rugby sevens,1,0,1,2
72,rugby sevens,1,0,1,2
68,rugby sevens,0,0,2,2
85,rugby sevens,0,2,0,2
96,rugby sevens,0,1,1,2
58,rugby sevens,0,1,1,2
93,rugby sevens,0,1,1,2
83,rugby sevens,0,1,1,2
92,rugby sevens,0,1,1,2
74,rugby sevens,0,2,0,2
88,rugby sevens,1,1,0,2
66,rugby sevens,2,0,0,2
95,rugby sevens,0,0,1,1
104,rugby sevens,0,0,1,1
103,rugby sevens,0,1,0,1
63,rugby sevens,1,0,0,1
78,rugby sevens,0,0,1,1
108,rugby sevens,1,0,0,1
79,rugby sevens,1,0,0,1
82,rugby sevens,0,0,1,1
71,rugby sevens,0,1,0,1
106,rugby sevens,1,0,0,1
91,rugby sevens,0,0,1,1
109,rugby sevens,1,0,0,1
86,rugby sevens,0,1,0,1
77,rugby sevens,0,0,0,0
97,rugby sevens,0,0,0,0
84,rugby sevens,0,0,0,0
94,rugby sevens,0,0,0,0
57,rugby sevens,0,0,0,0
101,rugby sevens,0,0,0,0
62,rugby sevens,0,0,0,0
55,rugby sevens,0,0,0,0
60,rugby sevens,0,0,0,0
80,rugby sevens,0,0,0,0
99,rugby sevens,0,0,0,0
113,rugby sevens,0,0,0,0
59,rugby sevens,0,0,0,0
54,rugby sevens,0,0,0,0
53,rugby sevens,0,0,0,0
100,rugby sevens,0,0,0,0
61,rugby sevens,0,0,0,0
107,rugby sevens,0,0,0,0
69,rugby sevens,0,0,0,0
76,rugby sevens,0,0,0,0
102,rugby sevens,0,0,0,0
56,rugby sevens,0,0,0,0
68,sailing,3,0,1,4
75,sailing,1,3,0,4
81,sailing,1,1,1,3
70,sailing,1,1,1,3
80,sailing,0,1,2,3
72,sailing,0,1,1,2
65,sailing,0,1,1,2
57,sailing,1,0,1,2
62,sailing,1,1,0,2
63,sailing,1,1,0,2
74,sailing,0,1,1,2
56,sailing,0,1,1,2
97,sailing,0,0,1,1
58,sailing,0,1,0,1
50,sailing,1,0,0,1
60,sailing,0,0,1,1
59,sailing,0,0,1,1
82,sailing,1,0,0,1
78,sailing,1,0,0,1
98,sailing,0,1,0,1
95,sailing,1,0,0,1
66,sailing,0,0,1,1
73,sailing,1,0,0,1
71,sailing,0,1,0,1
77,sailing,0,0,1,1
67,sailing,1,0,0,1
83,sailing,0,0,0,0
88,sailing,0,0,0,0
87,sailing,0,0,0,0
61,sailing,0,0,0,0
85,sailing,0,0,0,0
84,sailing,0,0,0,0
102,sailing,0,0,0,0
64,sailing,0,0,0,0
100,sailing,0,0,0,0
55,sailing,0,0,0,0
96,sailing,0,0,0,0
91,sailing,0,0,0,0
54,sailing,0,0,0,0
69,sailing,0,0,0,0
79,sailing,0,0,0,0
53,sailing,0,0,0,0
76,sailing,0,0,0,0
99,sailing,0,0,0,0
80,shooting,4,0,1,5
55,shooting,0,3,1,4
75,shooting,1,1,1,3
73,shooting,0,2,1,3
65,shooting,2,0,1,3
95,shooting,1,1,0,2
85,shooting,1,1,0,2
70,shooting,1,0,1,2
84,shooting,0,0,2,2
78,shooting,1,0,1,2
82,shooting,1,0,0,1
68,shooting,0,1,0,1
96,shooting,0,1,0,1
81,shooting,0,1,0,1
97,shooting,0,1,0,1
54,shooting,1,0,0,1
69,shooting,0,1,0,1
64,shooting,0,1,0,1
90,shooting,1,0,0,1
93,shooting,0,0,1,1
51,shooting,0,0,1,1
60,shooting,0,1,0,1
71,shooting,0,0,1,1
72,shooting,1,0,0,1
77,shooting,0,0,1,1
83,shooting,0,0,1,1
88,shooting,0,0,1,1
63,shooting,0,0,0,0
87,shooting,0,0,0,0
115,shooting,0,0,0,0
62,shooting,0,0,0,0
66,shooting,0,0,0,0
103,shooting,0,0,0,0
128,shooting,0,0,0,0
67,shooting,0,0,0,0
105,shooting,0,0,0,0
98,shooting,0,0,0,0
52,shooting,0,0,0,0
43,shooting,0,0,0,0
57,shooting,0,0,0,0
47,shooting,0,0,0,0
89,shooting,0,0,0,0
58,shooting,0,0,0,0
86,shooting,0,0,0,0
107,shooting,0,0,0,0
110,shooting,0,0,0,0
61,shooting,0,0,0,0
140,shooting,0,0,0,0
79,shooting,0,0,0,0
92,shooting,0,0,0,0
48,shooting,0,0,0,0
53,shooting,0,0,0,0
49,shooting,0,0,0,0
76,shooting,0,0,0,0
100,shooting,0,0,0,0
135,shooting,0,0,0,0
59,shooting,0,0,0,0
114,shooting,0,0,0,0
56,shooting,0,0,0,0
74,shooting,0,0,0,0
50,shooting,0,0,0,0
118,shooting,0,0,0,0
102,shooting,0,0,0,0
45,shooting,0,0,0,0
63,table tennis,2,1,1,4
65,table tennis,1,1,1,3
70,table tennis,1,1,0,2
54,table tennis,1,1,0,2
67,table tennis,1,1,0,2
72,table tennis,2,0,0,2
51,table tennis,0,1,1,2
48,table tennis,0,0,1,1
61,table tennis,0,1,0,1
55,table tennis,0,0,1,1
45,table tennis,0,0,1,1
78,table tennis,0,0,1,1
74,table tennis,0,0,1,1
60,table tennis,0,1,0,1
99,table tennis,0,0,0,0
49,table tennis,0,0,0,0
80,table tennis,0,0,0,0
47,table tennis,0,0,0,0
50,table tennis,0,0,0,0
73,table tennis,0,0,0,0
52,table tennis,0,0,0,0
66,table tennis,0,0,0,0
59,table tennis,0,0,0,0
88,table tennis,0,0,0,0
68,table tennis,0,0,0,0
81,table tennis,0,0,0,0
62,table tennis,0,0,0,0
83,table tennis,0,0,0,0
77,table tennis,0,0,0,0
76,table tennis,0,0,0,0
56,table tennis,0,0,0,0
75,table tennis,0,0,0,0
64,table tennis,0,0,0,0
85,table tennis,0,0,0,0
57,table tennis,0,0,0,0
93,table tennis,0,0,0,0
53,table tennis,0,0,0,0
69,table tennis,0,0,0,0
87,table tennis,0,0,0,0
46,table tennis,0,0,0,0
58,table tennis,0,0,0,0
82,table tennis,0,0,0,0
42,table tennis,0,0,0,0
71,table tennis,0,0,0,0
57,taekwondo,1,1,2,4
80,taekwondo,0,1,2,3
68,taekwondo,1,1,1,3
49,taekwondo,0,0,2,2
70,taekwondo,0,1,1,2
67,taekwondo,0,0,1,1
75,taekwondo,1,0,0,1
59,taekwondo,0,0,1,1
58,taekwondo,0,1,0,1
79,taekwondo,0,0,1,1
50,taekwondo,1,0,0,1
74,taekwondo,0,0,1,1
65,taekwondo,0,0,1,1
93,taekwondo,1,0,0,1
90,taekwondo,0,0,1,1
91,taekwondo,0,0,1,1
52,taekwondo,0,1,0,1
63,taekwondo,1,0,0,1
98,taekwondo,0,1,0,1
66,taekwondo,0,1,0,1
69,taekwondo,1,0,0,1
62,taekwondo,0,0,1,1
64,taekwondo,0,0,0,0
105,taekwondo,0,0,0,0
60,taekwondo,0,0,0,0
73,taekwondo,0,0,0,0
97,taekwondo,0,0,0,0
87,taekwondo,0,0,0,0
56,taekwondo,0,0,0,0
78,taekwondo,0,0,0,0
100,taekwondo,0,0,0,0
48,taekwondo,0,0,0,0
72,taekwondo,0,0,0,0
55,taekwondo,0,0,0,0
53,taekwondo,0,0,0,0
96,taekwondo,0,0,0,0
81,taekwondo,0,0,0,0
85,taekwondo,0,0,0,0
88,taekwondo,0,0,0,0
61,taekwondo,0,0,0,0
51,taekwondo,0,0,0,0
84,taekwondo,0,0,0,0
83,taekwondo,0,0,0,0
108,taekwondo,0,0,0,0
82,taekwondo,0,0,0,0
70,tennis,1,0,2,3
79,tennis,1,1,0,2
62,tennis,0,1,1,2
68,tennis,0,1,1,2
83,tennis,1,0,1,2
67,tennis,1,0,1,2
64,tennis,1,0,0,1
66,tennis,1,0,0,1
85,tennis,1,0,0,1
65,tennis,1,0,0,1
97,tennis,0,1,0,1
59,tennis,0,1,0,1
86,tennis,0,0,1,1
78,tennis,0,0,1,1
74,tennis,0,1,0,1
90,tennis,0,1,0,1
95,tennis,0,0,0,0
76,tennis,0,0,0,0
72,tennis,0,0,0,0
71,tennis,0,0,0,0
88,tennis,0,0,0,0
60,tennis,0,0,0,0
52,tennis,0,0,0,0
84,tennis,0,0,0,0
89,tennis,0,0,0,0
69,tennis,0,0,0,0
73,tennis,0,0,0,0
81,tennis,0,0,0,0
91,tennis,0,0,0,0
55,tennis,0,0,0,0
57,tennis,0,0,0,0
87,tennis,0,0,0,0
94,tennis,0,0,0,0
93,tennis,0,0,0,0
61,tennis,0,0,0,0
80,tennis,0,0,0,0
77,tennis,0,0,0,0
99,tennis,0,0,0,0
92,tennis,0,0,0,0
82,tennis,0,0,0,0
63,tennis,0,0,0,0
75,tennis,0,0,0,0
54,tennis,0,0,0,0
58,tennis,0,0,0,0
70,triathlon,1,1,0,2
54,triathlon,0,1,0,1
58,triathlon,1,0,0,1
59,triathlon,0,0,1,1
56,triathlon,0,0,1,1
44,triathlon,0,0,0,0
64,triathlon,0,0,0,0
63,triathlon,0,0,0,0
72,triathlon,0,0,0,0
55,triathlon,0,0,0,0
75,triathlon,0,0,0,0
61,triathlon,0,0,0,0
74,triathlon,0,0,0,0
60,triathlon,0,0,0,0
73,triathlon,0,0,0,0
68,triathlon,0,0,0,0
79,triathlon,0,0,0,0
53,triathlon,0,0,0,0
52,triathlon,0,0,0,0
69,triathlon,0,0,0,0
51,triathlon,0,0,0,0
62,triathlon,0,0,0,0
57,triathlon,0,0,0,0
77,triathlon,0,0,0,0
78,triathlon,0,0,0,0
80,triathlon,0,0,0,0
48,triathlon,0,0,0,0
46,triathlon,0,0,0,0
45,triathlon,0,0,0,0
66,triathlon,0,0,0,0
65,triathlon,0,0,0,0
67,triathlon,0,0,0,0
49,triathlon,0,0,0,0
50,triathlon,0,0,0,0
75,volleyball,3,1,5,9
72,volleyball,1,3,3,7
79,volleyball,2,1,4,7
78,volleyball,5,1,0,6
70,volleyball,3,1,0,4
100,volleyball,0,3,1,4
74,volleyball,1,1,1,3
83,volleyball,0,2,1,3
82,volleyball,0,3,0,3
95,volleyball,0,2,0,2
89,volleyball,1,0,1,2
99,volleyball,1,0,1,2
67,volleyball,1,1,0,2
66,volleyball,0,1,1,2
90,volleyball,0,0,2,2
88,volleyball,0,1,1,2
98,volleyball,0,1,1,2
102,volleyball,1,1,0,2
85,volleyball,1,1,0,2
76,volleyball,1,1,0,2
84,volleyball,0,0,1,1
65,volleyball,1,0,0,1
86,volleyball,0,0,1,1
80,volleyball,0,0,1,1
101,volleyball,1,0,0,1
103,volleyball,1,0,0,1
107,volleyball,1,0,0,1
105,volleyball,0,0,1,1
93,volleyball,1,0,0,1
92,volleyball,0,1,0,1
71,volleyball,1,0,0,1
73,volleyball,0,1,0,1
94,volleyball,0,0,1,1
81,volleyball,0,0,1,1
87,volleyball,1,0,0,1
97,volleyball,0,0,0,0
62,volleyball,0,0,0,0
68,volleyball,0,0,0,0
64,volleyball,0,0,0,0
58,volleyball,0,0,0,0
55,volleyball,0,0,0,0
96,volleyball,0,0,0,0
57,volleyball,0,0,0,0
106,volleyball,0,0,0,0
59,volleyball,0,0,0,0
91,volleyball,0,0,0,0
56,volleyball,0,0,0,0
115,volleyball,0,0,0,0
104,volleyball,0,0,0,0
52,volleyball,0,0,0,0
69,volleyball,0,0,0,0
77,volleyball,0,0,0,0
61,volleyball,0,0,0,0
63,volleyball,0,0,0,0
62,weightlifting,2,2,1,5
69,weightlifting,2,2,1,5
53,weightlifting,1,1,1,3
105,weightlifting,1,1,1,3
74,weightlifting,1,0,1,2
48,weightlifting,1,0,1,2
94,weightlifting,1,1,0,2
57,weightlifting,1,1,0,2
84,weightlifting,1,0,1,2
77,weightlifting,0,1,1,2
56,weightlifting,1,1,0,2
63,weightlifting,0,0,1,1
75,weightlifting,0,1,0,1
92,weightlifting,0,0,1,1
120,weightlifting,1,0,0,1
136,weightlifting,0,0,1,1
68,weightlifting,0,0,1,1
100,weightlifting,0,1,0,1
85,weightlifting,0,1,0,1
47,weightlifting,0,1,0,1
157,weightlifting,1,0,0,1
55,weightlifting,0,0,1,1
143,weightlifting,0,0,1,1
144,weightlifting,0,1,0,1
76,weightlifting,1,0,0,1
58,weightlifting,0,0,1,1
104,weightlifting,0,0,0,0
70,weightlifting,0,0,0,0
130,weightlifting,0,0,0,0
60,weightlifting,0,0,0,0
110,weightlifting,0,0,0,0
145,weightlifting,0,0,0,0
155,weightlifting,0,0,0,0
50,weightlifting,0,0,0,0
93,weightlifting,0,0,0,0
80,weightlifting,0,0,0,0
127,weightlifting,0,0,0,0
159,weightlifting,0,0,0,0
123,weightlifting,0,0,0,0
152,weightlifting,0,0,0,0
107,weightlifting,0,0,0,0
73,weightlifting,0,0,0,0
122,weightlifting,0,0,0,0
67,weightlifting,0,0,0,0
114,weightlifting,0,0,0,0
149,weightlifting,0,0,0,0
61,weightlifting,0,0,0,0
119,weightlifting,0,0,0,0
146,weightlifting,0,0,0,0
81,weightlifting,0,0,0,0
52,weightlifting,0,0,0,0
170,weightlifting,0,0,0,0
101,weightlifting,0,0,0,0
124,weightlifting,0,0,0,0
87,weightlifting,0,0,0,0
163,weightlifting,0,0,0,0
138,weightlifting,0,0,0,0
65,wrestling,1,3,3,7
75,wrestling,2,1,1,4
130,wrestling,1,1,2,4
58,wrestling,0,1,3,4
74,wrestling,1,1,2,4
97,wrestling,0,1,2,3
125,wrestling,1,0,2,3
85,wrestling,1,1,1,3
66,wrestling,1,0,2,3
80,wrestling,0,1,2,3
98,wrestling,1,1,1,3
69,wrestling,1,1,1,3
63,wrestling,0,1,2,3
56,wrestling,1,0,1,2
59,wrestling,1,0,1,2
61,wrestling,2,0,0,2
100,wrestling,0,0,2,2
48,wrestling,0,1,1,2
86,wrestling,1,1,0,2
53,wrestling,1,0,0,1
90,wrestling,0,0,1,1
57,wrestling,1,0,0,1
62,wrestling,0,0,1,1
51,wrestling,0,0,1,1
91,wrestling,0,0,1,1
77,wrestling,0,0,1,1
115,wrestling,0,1,0,1
67,wrestling,0,1,0,1
102,wrestling,1,0,0,1
73,wrestling,0,0,1,1
55,wrestling,0,1,0,1
68,wrestling,0,0,0,0
89,wrestling,0,0,0,0
88,wrestling,0,0,0,0
105,wrestling,0,0,0,0
116,wrestling,0,0,0,0
47,wrestling,0,0,0,0
52,wrestling,0,0,0,0
128,wrestling,0,0,0,0
117,wrestling,0,0,0,0
127,wrestling,0,0,0,0
96,wrestling,0,0,0,0
84,wrestling,0,0,0,0
106,wrestling,0,0,0,0
103,wrestling,0,0,0,0
70,wrestling,0,0,0,0
60,wrestling,0,0,0,0
64,wrestling,0,0,0,0
71,wrestling,0,0,0,0
50,wrestling,0,0,0,0
79,wrestling,0,0,0,0
95,wrestling,0,0,0,0
76,wrestling,0,0,0,0
81,wrestling,0,0,0,0
82,wrestling,0,0,0,0
78,wrestling,0,0,0,0
92,wrestling,0,0,0,0
122,wrestling,0,0,0,0
87,wrestling,0,0,0,0
120,wrestling,0,0,0,0
54,wrestling,0,0,0,0
39,wrestling,0,0,0,0
